name	class_label
AAGAATVLLVIVLLAGSYLAVLA	TM
LWIVIACLACVGSAAALTLRA	TM
FYRFYMLREGTAVPAVWFSIELIFGLFA	TM
GTLELGVDYGRAN	TM
KLFWRAVVAEFLATTLFVFISIGSALGFK	TM
HGSIGAGVDW	TM
ATIYLVCFCFFKQLAMIFMSVLAGNMYE	TM
GKLSLAATRSSE	TM
TSRLLLAGVALGIICSALMTWAIYF	TM
LGFFLVTFGFIWGMMLL	TM
YMLFTMIFVISSIIITVVVI	TM
ACFSAKVN	TM
LIWVAATLAGAIIAVLLVIYA	TM
HIPFAFAFAILAYLTLVLFRPVM	TM
CGLLVLLTLLLMGAIVTLGVF	TM
TGVYILVGVVLWTA	TM
LSMFIITPVMVLGTIFIFVMG	TM
MTLVALLVIGVSLTGYLGLKA	TM
QLYYQVLNFGMIVSSALMIW	TM
ALGALCLLLSVGSATACLLLGA	TM
LAVIFFFASALLYSQAAT	TM
MGHQLLVQLESIAITIVWSGVVAFIGYKLADLT	TM
ADILILSLLVIQCALGLLTIPFSA	TM
RHQQATFAGFIKGATWVSILSIAVLVFLALAN	TM
GTKWWTVGIRPMYKW	TM
PAIRVFATYAKWDEK	TM
PHVFLLFITFPILFIGWGSQS	TM
AGLVLWGAIIFVGWNALLLLFFW	TM
TQIVLLGLVTAALWAGLLTLLLLWHW	TM
SFIGRVFLFLMIVLPLWCGLHRMHHAMHD	TM
MYLGAGIALIPVIMSINYL	TM
FQTGFDFSD	TM
LISGTLGIICLSLMATLGILL	TM
FPFLNNLSFWFTVVGVILVNVSLG	TM
LDIYTRLGGMVWR	TM
FLIFLLVIMTVITVALLTLLF	TM
KDIGILYLFTAGIVGLISVCFTVYMRMELQH	TM
PLFYIINILVPCVLISFMINLVFYL	TM
HKALKTLGIIMGVFTLCWLPFFLVNIVNVF	TM
ANLKKLKTLMSAFLIVLGLLTFGA	TM
IWVGIFLLAALLAALFVCLKA	TM
KGAAGITGAGFITLAATLS	TM
VVLLAIVTLISVVQNGFFAHKV	TM
IAIDVLAVLVPLAAFLLDGSPDWSLYCAVWLLKPLRDS	TM
ALTVGTLLFLTGIGAASWAIV	TM
ITLIIFGVMAGVIGTILLISYGI	TM
WVWISLYYVAFYVVMSGIFAL	TM
GSNVALHVN	TM
GVLELGVDYGRAN	TM
IYLLILIILSMLCLVYASVPL	TM
LCSFLFVIVLFVATFYTL	TM
PLYFIVNVVIPCLLFSFLTGLVFYL	TM
ALLIAGGVGLLALAAALVLNA	TM
IWTWLRTTL	TM
PAHMIAISFFFTNALALALHGALVLSAA	TM
GGSLYIVGIFLPIWTFMIYIF	TM
GLTLGTGGR	TM
STVTGGYAQS	TM
DCFLLLVLLLYAPVGFCLLVL	TM
FWRAVVAEFLAMILFIFISIGSALG	TM
DPVLYQHILWFFGHPEVYIIILPGFGIISHVISTFAK	TM
LTFTEKWN	TM
IRDTLMRLVLTVRSN	TM
GKLSLAATRSTE	TM
GYNKFVVQYATDA	TM
QFHTMLMIAASGAVLIALGILCLVIQMYVSIR	TM
LILVLFVVLVSSVGVSLTLYA	TM
MASLWADYT	TM
DAWSGFVRGYGYDNRTN	TM
RWLWDFVNA	TM
MFVALLGLGLGQVVCSVALFF	TM
NMSTYVDYII	TM
IWVKMTFIVVLGLCFVFFWSF	TM
SLLISVVLVAYYLYIPLPDAI	TM
RKTTINGLIVAVILGVCFTGLQAYEYSHA	TM
IPVQLLWVNLVTDGLPATALG	TM
LAVIAGGVGFIMVAVLLVLFA	TM
MNKRNIMNLILAGGAGLPITTLALGYGAFF	TM
IALIVAGLSALGIATALVLNA	TM
NGNMWRILDHGAISL	TM
VAIICAAVVAVGLIVGLSVGL	TM
FSFLIVAGATTLFCLLHFGVI	TM
VGISIATIVAIIAAIYYVPW	TM
PLFAWSVFITAWLILLSLPVLAGAITMLLMDRNF	TM
LILIGAGLGVLALAAGLILTA	TM
LGLAAGAIYYYNTSNVFA	TM
QLGAGAFGGYQV	TM
IAIALLVILVVCSLITMSVIL	TM
LAFLIGGIIGGLLLLIGVSCCLW	TM
NGHMLRILDHGAISM	TM
MALILGIDRFMSECRALTNF	TM
AVIAGTTLAITALAVTS	TM
LYIVLAILCGVSIAVALALTA	TM
AAVTLGVLCLGLLVTVILLILQL	TM
LWLVIGVLTAAALAVTLIALA	TM
GTLLLLTAIGAASWAIVAVLL	TM
LLLVASVIQGLGLLLCFTYICLHFSAL	TM
AMIVALIVICITAVVAALV	TM
LVFIGTCGAVLAVALGLVLWA	TM
TRFGIAAKYQ	TM
IPWAVLIVVLITSLIIALIAL	TM
LWVVCAVLAGLGLTTALVLYA	TM
FAGRVLAGAVMMSGIGIFGLWAGIL	TM
LLIVLAGLAVVAVASGLILNA	TM
VGSIVGGIYLGFCFNAGAPAVEAFI	TM
MLSLGVSYR	TM
LTKWFFCCVCTILTMPFF	TM
LATIAASAIVLVVAVGLGLMA	TM
PIVVTGAVY	TM
KPHNLPMVFTGTAILYIGWFGFNAGSA	TM
DEFGEQLSKVISLICVAVWL	TM
HTLLTGVDF	TM
SVELIALLAISCTFFLFMHT	TM
LLIALLIYWTLAFITKTIKF	TM
FKLVIFVVLGIAIASGLMLYA	TM
CTLSISVLLAQTIFLFLIA	TM
FVIAGGTLAIPILAFVASFLL	TM
LLVITAIVLILSAAVGLVMYA	TM
LALATALIGGVAAIASLLLYA	TM
NPVIVIINLITLAAALLHTKTWFEL	TM
FIVVAGVVILAVTIALLVYFL	TM
IGLMCFLSIIITTVCIIMIAT	TM
FSVDTQLQS	TM
EVYILLNWIGYVNSGFNPLIYCRS	TM
LTLAVALIVGVSAIASLLLYA	TM
LYLAVVVLIGIGLTTTLVLYA	TM
MSTAISVLLAQAVFLLLT	TM
ALPGLMNKMEKAGCKRSVV	TM
KQFIRYLISSNVGEVVCIFL	TM
KYVVSSLVLVYGLIKVLTWIF	TM
TGVSPVFAGGVEYA	TM
IVIVLGILCFLLLLTVAVLVI	TM
KSLGILGILLGVAALCTIVALSVV	TM
LCLFVVTPVMVVGTAWIFL	TM
LYLAIVVLIGVALTATLMLYA	TM
LTILLAIAPVLALAVGLALYG	TM
FFVLLLMILILVNLAMTIWIL	TM
FIVLIPSVVITVIFLFFWLFM	TM
ILVLLILAVITIFALVCVLLV	TM
TYFIVLIPSVVITVIFLFFWLFM	TM
FLVLFIFLTSFFLNYSHTMVA	TM
GDKIGMFFQAMATFFGGFIIGF	TM
SNGVIVGTCLAFVAGMIGMAYAA	TM
FTFEGAARSDD	TM
MNYMVYFNFFACVLVPLLLMLGVYL	TM
AGLILLVVTLIGMSVLVRVLI	TM
VFLAVYLLGGITFLPLVLFTL	TM
LIKISALVFVTVAFFYLG	TM
GFFGVATFFFAALGIILIAWSAVL	TM
GQWEISVIWGLGVAMAIYLTA	TM
LWWIQAMTGFAMFFLGSVHLYIMMT	TM
IAVVITVVFLTLLSVVILIFF	TM
QVVATATFR	TM
MLLCFAFLWVLGIAYYMY	TM
IFCIIMLFALLGFL	TM
PLCICVAFTCLALVLVTSIVL	TM
LIIVLAIVVGVGAAVGLALSA	TM
ILVPCVLGLLLLPILAMLMALCV	TM
LGLLLAALICVGIATTLVLNA	TM
GYAAYYLVRKNFALAMPYLVE	TM
LPRTLAVLLVGAALAISGAVMQALF	TM
ILLFYVIFYGCLAGIFIGTIQ	TM
IMSTLLEVGYDNVKSQ	TM
LLAVALIIAMSISLAWQAAGW	TM
IVGQLLFVALGITFIYYLFTP	TM
NFWMFGLFFFFYFFIMGAYFPFFPIWL	TM
LVLIVGIVAAVGVAAALVLNA	TM
LTLAVALIGGVAAITSLLLYA	TM
ASGGIILIIAAILAMIMAN	TM
GSAGGAALAVVVLALAFGLSG	TM
LFVLLLLAILVVNLALTIWIL	TM
SPPLVLAALVACIIVLGFNYWIA	TM
LLFLILGIISFITFFLQGFTF	TM
LIVKALGILCFLLLITVAVLAV	TM
QYIHVAFQGSFACITVGLIVGAL	TM
QGIAVFGYSMAVSIGGILASR	TM
DHKRLGIMYIIVAIVMLLRGFADAIMMR	TM
IFRLHLVLGMTLFLLF	TM
LVSAIILTSFMTGLFILSLWK	TM
AVVGGVIAAVFITLITVVVLI	TM
INLGCDVDFD	TM
ALSALCLLLSVGSAAACLLLGA	TM
FTVIAGAVIVLLLTLNSNS	TM
LLFVSLLFCLIAQTCWLALV	TM
MVLVALLVIGVSLAGYLGLKA	TM
LVIPHILRLC	TM
LIRVLLGFVILFITYILFPSI	TM
PLFYIINILAPCVLIALMANLVFYL	TM
HKLGLGLEFQA	TM
ILFVAVSFIALGCVSAFVLFE	TM
AVVSAQIAITASPIS	TM
LTIIGGALFVLAVAAGLVLNA	TM
GCCGLLALALCSLALSLLA	TM
LIVLLAIVTIIAIALVAILP	TM
TEISAGWG	TM
FWRYFAGNLASGGAAGATSLCFVYPLDFARTRLAA	TM
IVAALGIIGLWMFFSSNELSIAT	TM
MTVILFVLLGISIASALVLYA	TM
SNATIAVACLSFFVCMIGAAYAS	TM
LKLTFDSSFS	TM
LNVLLSAAINFFLIAFAVYFLV	TM
HSAMLWTIGFIVTFSVGGMTGVLLAVPGADFV	TM
AVLSAKGQY	TM
LWELVIEQFEDLLVRILLLAA	TM
FFIVMGLVDAIPMIAVGLGLY	TM
LAVIAGGMGFIATAVLLVLFA	TM
ACYCRIPACLAGERRYGTCFYMGRVWAFCC	AMP
AGRGKQGGKVRAKAKTRSSRAGLQFPVGRVHRLLRKGNY	AMP
ALFSILRGLKKLGNMGQAFVNCKIYKKC	AMP
ALSILKGLEKLAKMGIALTNCKATKKC	AMP
ALWKDILKNVGKAAGKAVLNTVTDMVNQ	AMP
ALWKNMLKGIGKLAGQAALGAVKTLVGAES	AMP
ALWKTLLKNVGKAAGKAALNAVTDMVNQ	AMP
ALWKTMLKKLGTMALHAGKAAFGAAADTISQ	AMP
ALWKTMLKKLGTMALHAGKAALGAAADTISQGTQ	AMP
APGNKAECEREKGYCGFLKCSFPFVVSGKCSRFFFCCKNIW	AMP
ASIIKTTIKVSKAVCKTLTCICTGSCSNCK	AMP
ATCDLLSGTGIKHSACAAHCLLRGNRGGYCNGRAICVCRN	AMP
ATTGCSCPQCIIFDPICASSYKNGRRGFSSGCHMRCYNRCHGTDYFQISKGSKCI	AMP
AYPGNGVHCGKYSCTVDKQTAIGNIGNNAA	AMP
CANSCSYGPLTWSCDGNTK	AMP
CRQSCSFGPLTFVCDGNTK	AMP
DDTPSSRCGSGGWGPCLPIVDLLCIVHVTVGCSGGFGCCRIG	AMP
DFASCHTNGGICLPNRCPGHMIQIGICFRPRVKCCRSW	AMP
DFKDWMKTAGEWLKKKGPGILKAAMAAAT	AMP
DGVKLCDVPSGTWSGHCGSSSKCSQQCKDREHFAYGGACHYQFPSVKCFCKRQC	AMP
DKLIGSCVWGAVNYTSDCNGECKRRGYKGGHCGSFANVNCWCET	AMP
ELCEKASKTWSGNCGNTGHCDNQCKSWEGAAHGACHVRNGKHMCFCYFNC	AMP
FCKSLPLPLSVK	AMP
FFGSLLSLGSKLLPSVFKLFQRKKE	AMP
FFGSVLKLIPKIL	AMP
FFGWLIKGAIHAGKAIHGLIHRRRH	AMP
FFGWLIRGAIHAGKAIHGLIHRRRH	AMP
FFPIVAGVAGQVLKKIYCTISKKC	AMP
FGLPMLSILPKALCILLKRKC	AMP
FIGLLISAGKAIHDLIRRRH	AMP
FIGPIISALASLFG	AMP
FKLGSFLKKAWKSKLAKKLRAKGKEMLKDYAKGLLEGGSEEVPGQ	AMP
FLGGLMKAFPAIICAVTKKC	AMP
FLGGLMKAFPALICAVTKKC	AMP
FLNALKNFAKTAGKRLKSLLN	AMP
FLPAIAGMAAKFLPKIFCAISKKC	AMP
FLPAIAGVAAKFLPKIFCAISKKC	AMP
FLPAIVGAAAKFLPKIFCVISKKC	AMP
FLPAIVGAAGKFLPKIFCAISKKC	AMP
FLPAIVGAAGQFLPKIFCAISKKC	AMP
FLPAVLRVAAKIVPTVFCAISKKC	AMP
FLPAVLRVAAKVVPTVFCLISKKC	AMP
FLPAVLRVAAQVVPTVFCAISKKC	AMP
FLPFIAGMAAKFLPKIFCAISKKC	AMP
FLPFIAGMAANFLPKIFCAISKKC	AMP
FLPFIAGVAAKFLPKIFCAISKKC	AMP
FLPFLATLLSKVL	AMP
FLPGLLAGLL	AMP
FLPIASLLGKYL	AMP
FLPIIAGVAAKVFPKIFCAISKKC	AMP
FLPIIASVAAKVFPKIFCAISKKC	AMP
FLPIIASVAAKVFSKIFCAISKKC	AMP
FLPIIASVAANVFSKIFCAISKKC	AMP
FLPILASLAAKFGPKLFCLVTKKC	AMP
FLPILASLAAKLGPKLFCLVTKKC	AMP
FLPILASLAATLGPKLLCLITKKC	AMP
FLPLFASLIGKLL	AMP
FLPLIGKVLSGIL	AMP
FLPLIGRVLSGIL	AMP
FLPLLAGLAANFFPKIFCKITRKC	AMP
FLPLLAGLAANFLPKIFCKITRKC	AMP
FLPLLAGLAANFLPTIICKISYKC	AMP
FLPMLAGLAASMVPKFVCLITKKC	AMP
FLPVVAGLAAKVLPSIICAVTKKC	AMP
FMGGLIKAATKIVPAAYCAITKKC	AMP
FSFKRLKGFAKKLWNSKLARKIRTKGLKYVKNFAKDMLSEGEEAPPAAEPPVEAPQ	AMP
FVPYNPPRPGQSKPFPSFPGHGPFNPKIQWPYPLPNPGH	AMP
GAIKDALKGAAKTVAVELLKKAQCKLEKTC	AMP
GFFSLIKGVAKIATKGLAKNLGKMGLDLVGCKISKEC	AMP
GFFSTVKNLATNVAGTVIDTLKCKVTGGCRS	AMP
GFGALFKFLAKKVAKTVAKQAAKQGAKYVVNKQME	AMP
GFISTVKNLATNVAGTVIDTIKCKVTGGC	AMP
GFKGAFKNVMFGIAKSAGKSALNALACKIDKSC	AMP
GFLDSFKNAMIGVAKSVGKTALSTLACKIDKSC	AMP
GFLSILKKVLPKVMAHMK	AMP
GFLSTVKNLATNVAGTVIDTLKCKVTGGCRS	AMP
GFMKYIGPLIPHAVKAISDLI	AMP
GFSSIFRGVAKFASKGLGKDLARLGVNLVACKISKQC	AMP
GFVDLAKKVVGGIRNALGI	AMP
GIFPKIIGKGIKTGIVNGIKSLVKGVGMKVFKAGLNNIGNTGCNEDEC	AMP
GIFPKIIGKGIKTGIVNGIKSLVKGVGMKVFKAGLSNIGNTGCNEDEC	AMP
GIFSKFGGKAIKNLFIKGAKNIGKEVGMDVIRTGIDVAGCKIKGEC	AMP
GIFSKLAGKKLKNLLISGLKNVGKEVGMDVVRTGIDIAGCKIKGEC	AMP
GIFSKLGRKKIKNLLISGLKNVGKEVGMDVVRTGIDIAGCKIKGEC	AMP
GIFSLIKGAAQLIGKTVAKEAGKTGLELMACKVTKQC	AMP
GIFTLIKGAAKLIGKTVAKEAGKTGLELMACKITNQC	AMP
GILDAIKAIAKAAG	AMP
GILDFAKTVVGGIRNALGI	AMP
GILSLFTGGIKALGKTLFKMAGKAGAEHLACKATNQC	AMP
GILSSIKGVAKGVAKNVAAQLLDTLKCKITGC	AMP
GIMDSVKGLAKNLAGKLLDSLKCKITGC	AMP
GIMDTIKDTAKTVAVGLLNKLKCKITGC	AMP
GINTLKKVIQGLHEVIKLVSNHA	AMP
GINTLKKVIQGLHEVIKLVSNHE	AMP
GIPCGESCVWIPCISAALGCSCKNKVCYRN	AMP
GKLQAFLAKMKEIAAQTL	AMP
GKVWDWIKSAAKKIWSSEPVSQLKGQVLNAAKNYVAEKIGATPT	AMP
GLADFLNKAVGKVVDFVKS	AMP
GLFDVVKGVLKGVGKNVAGSLLEQLKCKLSGGC	AMP
GLFKVLGSVAKHLLPHVAPIIAEKL	AMP
GLFLDTLKGAAKDVAGKLLEGLKCKIAGCKP	AMP
GLFLDTLKGLAGKLLQGLKCIKAGCKP	AMP
GLFSILRGAAKFASKGLGKDLTKLGVDLVACKISKQC	AMP
GLFSKFNKKKIKSGLFKIIKTAGKEAGLEALRTGIDVIGCKIKGEC	AMP
GLFSKFNKKKIKSGLIKIIKTAGKEAGLEALRTGIDVIGCKIKGEC	AMP
GLFSVLGSVAKHLLPHVAPIIAEKL	AMP
GLFSVLGSVAKHLLPHVVPVIAEKL	AMP
GLFTLIKGAAKLIGKTVAKEAGKTGLELMACKITNQC	AMP
GLLDFVTGVGKDIFAQLIKQI	AMP
GLLDSIKGMAISAGKGALQNLLKVASCKLDKTC	AMP
GLLDSLKNLAINAAKGAGQSVLNTLSCKLSKTC	AMP
GLLDTIKGVAKTVAASMLDKLKCKISGC	AMP
GLLGGLLGPLLGGGGGGGGGLL	AMP
GLLGPLLKIAAKVGSNLL	AMP
GLLGSIFGAGKKIACALSGLC	AMP
GLLGSLFGAGKKVACALSGLC	AMP
GLLKRIKTLL	AMP
GLLSGLKKVGKHVAKNVAVSLMDSLKCKISGDC	AMP
GLLSKVLGVGKKVLCGVSGLC	AMP
GLLSVLGSVAKHVLPHVVPVIAEHL	AMP
GLMSSIGKALGGLIVDVLKPKTPAS	AMP
GLNALKKVFQGIHEAIKLINNHVQ	AMP
GLNTLKKVFQGLHEAIKLINNHVQ	AMP
GLWNKIKEAASKAAGKAALGFVNEMV	AMP
GLWSKIKAAGKEAAKAAAKAAGKAALNAVSEAV	AMP
GLWSKIKEAAKTAGLMAMGFVNDMV	AMP
GLWSTIKQKGKEAAIAAAKAAGQAALGAL	AMP
GPLSCGRNGGVCIPIRCPVPMRQIGTCFGRPVKCCRSW	AMP
GRLQAFLAKMKEIAAQTL	AMP
GRPNPVNNKPTPHPRL	AMP
GRPNPVNTKPTPYPRL	AMP
GSGRGSCRSQCMRRHEDEPWRVQECVSQCRRRRGGGD	AMP
GSKKPVPIIYCNRRTGKCQRM	AMP
GVLDILKNAAKNILAHAAEQI	AMP
GVVDILKGAGKDLLAHLVGKISEKV	AMP
GWKDWAKKAGGWLKKKGPGMAKAALKAAMQ	AMP
GWKDWLKKGKEWLKAKGPGIVKAALQAATQ	AMP
GWKDWLNKGKEWLKKKGPGIMKAALKAATQ	AMP
HGVSGHGQHGVHG	AMP
IFGAILPLALGALKNLIK	AMP
IIEKLVNTALGLLSGL	AMP
IIGHLIKTALGMLGL	AMP
ILGTILGLLKGL	AMP
ILGTILGLLKSL	AMP
ILPLVGNLLNDLL	AMP
ILQKAVLDCLKAAGSSLSKAAITAIYNKIT	AMP
INWKKIAEIGKQVLSAL	AMP
INWKKIAEVGGKILSSL	AMP
INWLKLGKAIIDAL	AMP
IPRPLDPCIAQNGRCFTGICRYPYFWIGTCRNGKSCCRRR	AMP
IWLTALKFLGKHAAKHLAKQQLSKL	AMP
KDRPKKPGLCPPRPQKPCVKECKNDDSCPGQQKCCNYGCKDECRDPIFVG	AMP
KTCEHLADTYRGVCFTNASCDDHCKNKAHLISGTCHNWKCFCTQNC	AMP
KTCENLADTY	AMP
KTCENLSGTFKGPCIPDGNCNKHCRNNEHLLSGRCRDDFRCWCTNRC	AMP
KTCMTKKEGWGRCLIDTTCAHSCRKYGYMGGKCQGITRRCYCLLNC	AMP
KWCFRVCYRGICYRKCR	AMP
KWCFRVCYRGICYRRCR	AMP
KYYGNGVSCNKKGCSVDWGKAIGIIGNNSAANLATGGAAGWSK	AMP
LCNERPSQTWSGNCGNTAHCDKQCQDWEKASHGACHKRENHWKCFCYFNC	AMP
LFCRKGTCHFGGCPAHLVKVGSCFGFRACCKWPWDV	AMP
LLGRCKVKSNRFHGPCLTDTHCSTVCRGEGYKGGDCHGLRRRCMCLC	AMP
LLGRCKVKSNRFNGPCLTDTHCSTVCRGEGYKGGDCHGLRRRCMCLC	AMP
LLKELWTKIKGAGKAVLGKIKGLL	AMP
LLKELWTKMKGAGKAVLGKIKGLL	AMP
LLPILGNLLNGLL	AMP
LLPNLLKSLL	AMP
LMCTHPLDCSN	AMP
LNLKGIFKKVASLLT	AMP
LPVNEAQCRQVGGYCGLRICNFPSRFLGLCTRNHPCCSRVWV	AMP
MSWLNFLKYIAKYGKKAVSAAWKYKGKVLEWLNVGPTLEWVWQKLKKIAGL	AMP
QDKCKKVYENYPVSKCQLANQCNYDCKLDKHARSGECFYDEKRNLQCICDYCEY	AMP
QGVRNHVTCRIYGGFCVPIRCPGRTRQIGTCFGRPVKCCRRW	AMP
QKLCERPSGTWSGVCGNNNACKNQCINLEKARHGSCNYVFPAHKCICYFPC	AMP
QQCGRQASGRLCGNRLCCSQWGYCGSTASYCGAGCQSQCRS	AMP
QRFIHPTYRPPPQPRRPVIMRA	AMP
RQRVEELSKFSKKGAAARRRK	AMP
RSGRGECRRQCLRRHEGQPWETQECMRRCRRRG	AMP
RSVCRQIKICRRRGGCYYKCTNRPY	AMP
SAPRGCWTKSYPPKPCK	AMP
SCTTCVCTCSCCTT	AMP
SFGLCRLRRGFCARGRCRFPSIPIGRCSRFVQCCRRVW	AMP
SGISGPLSCGRNGGVCIPIRCPVPMRQIGTCFGRPVKCCRSW	AMP
SIVPIRCRSNRDCRRFCGFRGGRCTYARQCLCGY	AMP
SKGKKANKDVELARG	AMP
SMLSVLKNLGKVGLGFVACKINKQC	AMP
TSYGNGVHCNKSKCWIDVSELETYKAGTVSNPKDILW	AMP
VDKGSYLPRPTPPRPIYNRN	AMP
VDKPDYRPRPRPPNM	AMP
VDKPDYRPRPWPRNMI	AMP
VDKPDYRPRPWPRPN	AMP
VDKPDYRPRPWPRPNM	AMP
VLPIIGNLLNSLL	AMP
VLPLISMALGKLL	AMP
VNPIILGVLPKFVCLITKKC	AMP
VRNFVTCRINRGFCVPIRCPGHRRQIGTCLGPQIKCCR	AMP
VRNHVTCRINRGFCVPIRCPGRTRQIGTCFGPRIKCCRSW	AMP
VTCDLLSFEAKGFAANHSLCAAHCLAIGRRGGSCERGVCICRR	AMP
VTCDLLSIKGVAEHSACAANCLSMGKAGGRCENGICLCRKTTFKELWDKRF	AMP
VTCFCKRPVCDSGETQIGYCRLGNTFYRLCCRQ	AMP
WLGSALKIGAKLLPSVVGLFKKKKQ	AMP
WNPFKELERAGQRVRDAIISAGPAVATVGQAAAIARG	AMP
WNPFKELERAGQRVRDAVISAAPAVATVGQAAAIARG	AMP
YDLSKNCRLRGGICYIGKCPRRFFRSGSCSRGNVCCLRFG	AMP
YSKSLPLSVLNP	AMP
YVSCLFRGARCRVYSGRSCCFGYYCRRDFPGSIFGTCSRRNF	AMP
